######################################################################
#....................................................................#
#....................................................................#
#....................................................................#
#....................................................................#
#....................................................................#
....................................#.................................
....................................#.................................
....................................#.................................
....................................#.................................
....................................#................................#
#...................................#................................#
#...................................#................................#
#...................................#................................#
#............................#####################...................#
#............................#.......................................#
#............................#.......................................#
#............................#.......................................#
#............................#.......................................#
#............................#........................................
.............................#........................................
......................................................................
......................................................................
......................................................................
.....................................................................#
#....................................................................#
#....................................................................#
#.....................####.#####.....................................#
#..............................#.....................................#
#..............................#.....................................#
#..............................#.....................................#
#..............................#.....................................#
#..............................#.....................................#
#....................................................................#
######################################################################

